{
  "textures": [
    "textures/tiles/dirt.png",
    "textures/tiles/dirt_green.png",
    "textures/tiles/water.png",
    "textures/tiles/sand.png",
    "textures/tiles/cactus_top.png",
    "textures/tiles/melon_top.png",
    "textures/tiles/flowering_azalea_top.png"
  ],
  "placable":
  [
    false,
    true,
    false,
    false,
    false,
    false,
    false
  ],
  "layout": [
    [0,1,1,1,1,1,1,1,1,4,3,3,3,4,1,1,1,1,1,1,1,1,1,1,1,1,1,1,1,1,1,1],
    [0,1,1,1,1,1,1,1,1,3,2,2,3,3,1,1,1,1,1,1,1,1,1,1,1,1,1,1,1,1,1,1],
    [0,1,1,1,1,1,1,1,1,3,2,2,2,3,1,0,0,0,0,0,0,0,0,0,0,0,0,0,0,1,1,1],
    [0,0,0,0,0,0,0,0,1,3,3,2,2,3,1,0,1,1,1,1,1,1,1,1,1,1,1,1,0,1,1,1],
    [1,1,1,1,1,1,1,0,1,3,2,2,2,3,1,0,1,1,1,1,1,1,1,1,1,1,1,1,0,1,1,1],
    [1,1,1,1,1,1,1,0,1,4,2,2,3,3,1,0,1,1,1,1,1,1,1,1,1,1,1,1,0,1,1,1],
    [1,1,1,1,1,1,1,0,1,3,3,3,3,1,1,0,1,1,1,0,0,0,0,0,1,1,1,1,0,1,1,1],
    [1,1,1,0,0,0,0,0,1,1,1,1,1,1,1,0,1,1,1,0,1,1,1,0,1,1,1,1,0,1,1,1],
    [1,1,1,0,1,1,1,1,1,1,1,1,1,1,1,0,1,1,1,0,1,1,1,0,1,1,1,1,0,1,1,1],
    [1,1,1,0,1,1,1,1,1,1,1,1,1,1,1,0,1,1,1,0,1,1,1,0,1,1,1,1,0,1,1,1],
    [1,1,1,0,0,0,0,0,0,0,0,0,0,0,0,0,1,1,1,0,1,1,1,0,1,1,1,1,0,1,1,1],
    [1,1,1,1,1,1,1,1,1,1,1,1,1,1,1,1,1,1,1,0,1,1,1,0,1,1,1,1,0,1,1,1],
    [1,1,1,1,1,1,1,1,1,1,1,1,1,1,1,1,1,1,1,0,1,1,1,0,1,1,1,1,0,1,1,1],
    [1,1,1,1,1,1,1,1,1,1,1,1,1,0,0,0,0,0,0,0,1,1,1,0,0,0,0,0,0,1,1,1],
    [1,1,1,1,1,1,1,1,1,1,1,1,1,0,1,1,1,1,1,1,1,1,1,1,1,1,1,1,1,1,1,1],
    [1,1,1,1,1,1,1,1,1,1,1,1,1,0,1,1,1,1,1,1,1,1,1,1,1,1,1,1,1,1,1,1]
  ],
  "route":[
    [0, 0],
    [0, 96],
    [224, 96],
    [224, 224],
    [96,224],
    [96,320],
    [480,320],
    [480,64],
    [896,64],
    [896,416],
    [736,416],
    [736,192],
    [608,192],
    [608,416],
    [416,416],
    [416,480]
  ]
}