{
  "textures": [
    "textures/tiles/dirt.png",
    "textures/tiles/dirt_green.png",
    "textures/tiles/water.png",
    "textures/tiles/sand.png",
    "textures/tiles/cactus_top.png",
    "textures/tiles/melon_top.png",
    "textures/tiles/flowering_azalea_top.png"
  ],
  "placable":
  [
    false,
    true,
    false,
    false,
    false,
    false,
    false
  ],
  "layout": [
    [1,1,0,1,1,1,1,1,1,4,3,3,3,4,1,1,1,1,1,1,1,1,1,1,1,1,1,1,1,1,1,1],
    [1,1,0,1,1,1,1,1,1,3,2,2,3,3,1,1,1,1,1,1,1,1,1,1,1,1,1,1,1,1,1,1],
    [1,1,0,1,1,1,1,1,1,3,2,2,2,3,1,0,0,0,0,0,0,0,0,0,0,0,0,0,0,1,1,1],
    [1,1,0,0,0,0,0,0,1,3,3,2,2,3,1,0,1,1,1,1,1,1,1,1,1,1,1,1,0,1,1,1],
    [1,1,1,1,1,1,1,0,1,3,2,2,2,3,1,0,1,1,1,1,1,1,1,1,1,1,1,1,0,1,1,1],
    [1,1,1,1,1,1,1,0,1,4,2,2,3,3,1,0,1,1,1,1,1,1,1,1,1,1,1,1,0,1,1,1],
    [1,1,1,1,1,1,1,0,1,3,3,3,3,1,1,0,1,1,1,0,0,0,0,0,1,1,1,1,0,1,1,1],
    [1,1,1,0,0,0,0,0,1,1,1,1,1,1,1,0,1,1,1,0,1,1,1,0,1,1,1,1,0,1,1,1],
    [1,1,1,0,1,1,1,1,1,1,1,1,1,1,1,0,1,1,1,0,1,1,1,0,1,1,1,1,0,1,1,1],
    [1,1,1,0,1,1,1,1,1,1,1,1,1,1,1,0,1,1,1,0,1,1,1,0,1,1,1,1,0,1,1,1],
    [1,1,1,0,0,0,0,0,0,0,0,0,0,0,0,0,1,1,1,0,1,1,1,0,1,1,1,1,0,1,1,1],
    [1,1,1,1,1,1,1,1,1,1,1,1,1,1,1,1,1,1,1,0,1,1,1,0,1,1,1,1,0,1,1,1],
    [1,1,1,1,1,1,1,1,1,1,1,1,1,1,1,1,1,1,1,0,1,1,1,0,1,1,1,1,0,1,1,1],
    [1,1,1,1,1,1,1,1,1,1,1,1,1,0,0,0,0,0,0,0,1,1,1,0,0,0,0,0,0,1,1,1],
    [1,1,1,1,1,1,1,1,1,1,1,1,1,0,1,1,1,1,1,1,1,1,1,1,1,1,1,1,1,1,1,1],
    [1,1,1,1,1,1,1,1,1,1,1,1,1,0,1,1,1,1,1,1,1,1,1,1,1,1,1,1,1,1,1,1]
  ],
  "route":[
    [0, 0],
    [0, 100],
    [100, 100]
  ]
}



